111111111111111
101010000001001
100000000000001
110010000010101
100011100010101
100000000010001
101100000011101
100100000011001
110000000010001
1000100N0010011
111000100000011
100000100000001
100111101000101
100001101100101
100000001100101
111111111111111
