11111111111
10000000001
10N00001001
10000001001
10000000001
11111111111 