1111111111111111
10000000001100001
10110000000100001
10010000000000001
10000000011100001
10000000000100001
11100100110111011
11000010110111011
11000000110101011
100N0100000000001
10000000000000001
11000000110101011
11110111111101011
11111111111111111