  11111111111111111
  10000000001100001
  10110000011100001
1110100000000000001
1011000001110000011
100000000001000011
11100110110111011
1100W010110111011
11000000110101011
10001000000000001
10000000000000001
11000000110101011
11110111111101011
11111111111111111 