1111111111111111111
1000000000000000001
1011000010000100001
1010000001000111001
10100N0000000000001
1000000000000000001
1100000000000000001
1110000000000001001
1100000000000001101
1000000010000000101
1000000010000000101
1100000011000100001
1110000000000110001
1111111111111111111