11111111111111111111111111111111111111111111111111
11111111111111111111111111111111111111111111111111
11111111111110000111111111111111110000111111111111
11111111111000000001111111111111000000001111111111
11111111000000000000001111111000000000000001111111
11111100000000000000000011100000000000000000011111
11110000000000000000000000000000000000000000001111
11100000000000000000000000000000000000000000000111
11100000000000000000000000000000000000000000000111
11000000000000000000000000000000000000000000000011
11000000000000000000000000000000000000000000000011
11000000000000000000000000000000000000000000000011
11100000000000000000000000000000000000000000000111
11110000000000000000000000000000000000000000000111
11111000000000000000000000000000000000000000001111
11111100000000000000000000000000000000000000111111
11111111000000000000000000000000000000000011111111
11111111100000000000000000000000000000001111111111
11111111111100000000000000000000000000111111111111
11111111111111100000000000000000000011111111111111
11111111111111111000000000000000001111111111111111
11111111111111111110000000000001111111111111111111
11111111111111111111100000001111111111111111111111
11111111111111111111111100011111111111111111111111
11111111111111111111111111111111111111111111111111
